1 0 0 1 1 1 1 1 1 1 1 1 1 1 1 1
1 0 7 0 0 0 0 0 0 3 3 0 0 3 3 1
1 0 0 7 7 0 0 0 0 3 0 0 5 5 0 1
1 1 1 0 0 0 7 0 0 0 4 0 0 5 0 1
1 0 0 0 7 0 0 0 0 0 0 0 0 0 0 1
1 0 0 7 0 8 0 8 0 8 0 8 0 8 0 1
1 0 7 0 0 0 0 0 0 0 0 0 0 0 0 1
1 7 0 0 0 0 0 0 0 0 0 0 0 0 0 1
1 0 7 1 1 1 1 0 7 1 1 1 1 6 6 1
1 0 7 7 7 0 7 7 6 2 2 2 2 2 2 2
1 0 0 0 7 7 0 6 2 2 2 2 2 2 2 2
1 1 1 1 1 1 1 1 2 2 1 1 1 1 1 1